NO assets/redbrick.xpm
SO assets/mossy.xpm
WE assets/colorstone.xpm
EA assets/greystone.xpm
F 42,42,42
C 84,84,84

1111111
1000001
1000001
100N001
1000001
1000001
1111111
