NO assets/redbrick.xpm
EA assets/greystone.xpm
SO assets/mossy.xpm
WE assets/colorstone.xpm
F 220,100,0
C 225,30,0
        1111111111111111111111111
        1000000000110000000000001
        1011000001110000000000001
        100100000000000000S000001
111111111011000001110000000000001
100000000011000001110111111111111
11110111111111011100000010001
1111011111111101110101001000
11000000110101011100000010001
100000000000000011000000100001
100000000000000011010100100000111
1100000111010101111101111000111
11110111 1110101 10111101000001
11111111 1111111 111111111111
