SO assets/mossy.xpm

















EA assets/greystone.xpm
WE assets/wood.xpm
C 241,249,4
NO assets/redbrick.xpm














F 240,240,240

        1111111111111111111111111
        1000000000110000000000001
        1011000001110000000000001
        1001000000000000000000001
111111111011000001110000000000001
100000000011000001110111111111111
11110111111111011100000010001
11110111111111011101010010001
11000000110101011100000010001
100000000000000011000000100001
100000000000000011010100100000111111111111111
110N000111010101111101111000000000000000000001
11110111 1110101 1011110100000111111111111111
11111111 1111111 1111111111111
