NO assets/redbrick.xpm
SO assets/mossy.xpm
WE assets/wood.xpm
EA assets/greystone.xpm

F 42,42,42
C 84,84,84

        1111111111111111111111111
        1000000000110000000000001
        1011000001110000000000001
        10010000000000000S0000001
111111111011000001110000000000001
100000000011000001110111111111111
11110111111111011100000010001
11110111111111011101010010001
11000000110101011100000010001
100000000000000011000000100001
1000000000000000110101001000001
1100000111010101111101111000111
11110111 1110101 10111101000001
11111111 1111111 111111111111
